37 11 1
0 0 
36 10
.#.........
.#.........
.#.........
.#.........
.#.........
.#.........
.#.........
.#.........
.#.........
.#.........
.#.........
.#.........
.#.........
.#.........
.#.........
.#.........
.#.........
.#.........
.#.........
.#.........
.#.........
.#.........
.#.........
.#.........
.#.........
.#.........
.#.........
.#.........
.#.........
.#.........
.#.........
.#.........
.#.........
.#...##....
.#..#......
.##.####.##
....#......