8 29 10
1 10
4 4
#.#.#.####.#..#..##.....#.#..
....#.##........#....#.......
.#.#.#..#.##..###..##....#...
#........#............#......
#..#....#..#.#....#...#...#..
..#...#.......###....#.#....#
....##...#...#....##.....#.#.
....##.....#..#..#.#.##..#...
